22222222222222222222
20000000000000000002
20001111000001111002
20000000000000000002
20000000000000000002
20000001111000000002
20000000000000000002
20000000000000000002
20000000000000000002
20000000000000000002
20000000000000000002
20000000000000000002
20000000000000000002
20000000000000000002
20000000000000000002
20000000000000000002
20000000000000000002
20000000000000000002
20000000000000000002
22222222222222222222